7 5
+-+-+-+-+-+-+-+
|S|   | | |   |
+ +-+ + + +-+ +
|   |   |     |
+ + + +-+ +-+ +
| |   |     | |
+ +-+-+ +-+-+ + 
|       |     |
+-+ + +-+-+ +-+
|   |        E|
+-+-+-+-+-+-+-+